1,1,1,1,1,1,1,1
1,1,1,1,1,1,1,1
1,1,3,3,3,3,1,1
1,1,-1,-1,-1,-1,1,1
1,1,-1,-1,22,102,1,1
1,1,-1,-1,22,-1,1,1
1,1,-1,-1,22,-1,1,1
1,1,101,-1,-1,-1,1,1
1,1,-1,-1,-1,-1,1,1
1,1,-1,22,-1,-1,1,1
1,1,-1,22,-1,100,1,1
1,1,-1,22,-1,-1,1,1
1,1,-1,-1,-1,-1,1,1
1,1,5,-1,20,103,1,1
1,1,1,1,1,1,1,1
