1,1,1,1,1,1,1,1
1,1,-1,-1,-1,-1,1,1
1,1,-1,-1,-1,-1,1,1
1,1,-1,-1,-1,-1,1,1
1,1,-1,-1,-1,-1,1,1
1,1,-1,-1,-1,-1,1,1
1,1,-1,-1,-1,-1,1,1
1,1,-1,-1,-1,-1,1,1
1,1,-1,-1,-1,-1,1,1
1,1,-1,-1,-1,102,1,1
1,1,-1,-1,-1,-1,1,1
1,1,-1,-1,-1,-1,1,1
1,1,101,-1,-1,-1,1,1
1,1,-1,-1,-1,-1,1,1
1,1,-1,-1,-1,-1,1,1
1,1,-1,-1,-1,100,1,1
1,1,-1,-1,-1,-1,1,1
1,1,-1,-1,-1,-1,1,1
1,1,5,-1,-1,103,1,1
1,1,1,1,1,1,1,1
