1,1,1,1,1,1,1,1,1,1,1,1,1,1,1,1,1,1,1,1,1,1,1,1,1,1,1,1,1,1,1
1,1,1,1,1,1,1,1,1,1,1,1,1,1,1,1,1,1,1,1,1,1,1,1,1,1,1,1,1,1,1
1,1,-1,-1,-1,-1,-1,-1,-1,1,1,-1,-1,-1,-1,-1,-1,-1,-1,-1,1,1,-1,-1,-1,-1,-1,-1,-1,1,1
1,1,-1,-1,-1,-1,-1,-1,-1,1,1,-1,-1,-1,-1,-1,-1,-1,-1,-1,1,1,-1,-1,-1,-1,-1,-1,-1,1,1
1,1,-1,22,-1,-1,22,-1,-1,-1,-1,-1,-1,22,-1,-1,-1,22,-1,-1,-1,-1,-1,-1,22,-1,-1,22,-1,1,1
1,1,-1,-1,108,-1,-1,-1,-1,-1,-1,-1,-1,-1,-1,101,-1,-1,-1,-1,-1,-1,-1,-1,-1,-1,104,-1,-1,1,1
1,1,2,2,2,2,2,2,-1,-1,-1,-1,2,2,2,2,2,2,2,-1,-1,-1,-1,2,2,2,2,2,2,1,1
1,1,-1,-1,-1,-1,-1,-1,-1,100,107,-1,-1,-1,-1,-1,-1,-1,-1,-1,105,102,-1,-1,-1,-1,-1,-1,-1,1,1
1,1,-1,22,-1,-1,22,-1,-1,-1,-1,-1,-1,22,-1,-1,-1,22,-1,-1,-1,-1,-1,-1,22,-1,-1,22,-1,1,1
1,1,20,5,-1,-1,-1,-1,4,4,4,4,-1,-1,-1,106,-1,-1,-1,4,4,4,4,-1,-1,-1,103,-1,20,1,1
1,1,1,1,1,1,1,1,1,1,1,1,1,1,1,1,1,1,1,1,1,1,1,1,1,1,1,1,1,1,1
