1,1,1,1,1,1,1,1
1,-1,-1,-1,-1,-1,-1,1
1,-1,-1,-1,-1,-1,-1,1
1,-1,-1,-1,-1,-1,-1,1
1,-1,-1,-1,-1,-1,-1,1
1,-1,22,-1,-1,22,-1,1
1,103,22,-1,-1,22,-1,1
1,-1,22,-1,-1,22,-1,1
1,-1,-1,-1,-1,-1,-1,1
1,-1,-1,-1,-1,-1,102,1
1,-1,-1,-1,-1,-1,-1,1
1,-1,-1,-1,-1,-1,-1,1
1,101,-1,-1,-1,-1,-1,1
1,-1,-1,-1,-1,-1,-1,1
1,-1,22,-1,-1,22,-1,1
1,-1,22,-1,-1,22,100,1
1,-1,22,-1,-1,22,-1,1
1,-1,-1,-1,-1,-1,-1,1
1,5,-1,-1,-1,-1,104,1
1,1,1,1,1,1,1,1
