1,1,1,1,1,1,1,1,1,1,1,1,1,1,1,1,1,1,1,1,1,1,1,1,1
1,-1,-1,-1,-1,-1,-1,-1,-1,-1,-1,-1,-1,-1,-1,-1,-1,-1,-1,-1,-1,-1,-1,-1,1
1,-1,-1,-1,-1,-1,-1,-1,-1,-1,-1,-1,-1,-1,-1,-1,-1,-1,-1,-1,-1,-1,-1,-1,1
1,-1,-1,-1,-1,22,-1,-1,-1,22,-1,-1,-1,-1,-1,22,-1,-1,-1,22,-1,-1,-1,-1,1
1,-1,-1,-1,-1,-1,-1,-1,-1,-1,-1,-1,-1,-1,-1,-1,-1,-1,-1,-1,-1,-1,-1,-1,1
1,-1,-1,-1,-1,-1,-1,-1,-1,-1,-1,-1,-1,-1,-1,-1,-1,-1,-1,-1,-1,-1,-1,-1,1
1,-1,-1,-1,-1,2,2,2,2,2,-1,-1,-1,-1,-1,2,2,2,2,2,-1,-1,-1,-1,1
1,-1,-1,-1,-1,22,-1,-1,-1,22,-1,-1,-1,-1,-1,22,-1,-1,-1,3,-1,-1,-1,-1,1
1,-1,-1,-1,-1,-1,-1,-1,-1,-1,-1,-1,-1,-1,-1,-1,-1,-1,-1,3,-1,-1,-1,-1,1
1,-1,-1,-1,-1,-1,-1,10,-1,-1,-1,-1,-1,-1,-1,-1,-1,12,-1,3,-1,-1,-1,-1,1
1,-1,-1,-1,-1,1,1,1,1,2,2,2,2,2,2,2,1,1,1,1,-1,-1,-1,-1,1
1,22,-1,-1,22,-1,-1,-1,-1,-1,-1,-1,11,-1,-1,-1,-1,-1,-1,3,22,-1,-1,22,1
1,-1,-1,-1,-1,-1,-1,-1,-1,-1,-1,-1,-1,-1,-1,-1,-1,-1,-1,3,-1,-1,-1,-1,1
1,-1,5,-1,-1,-1,-1,-1,20,-1,4,4,4,4,4,-1,20,21,-1,3,-1,24,13,-1,1
1,1,1,1,1,1,1,1,1,1,1,1,1,1,1,1,1,1,1,1,1,1,1,1,1
