1,1,1,1,1,1,1,1,1,1,1,1,1,1,1,1,1,1,1,1,1,1,1,1
1,-1,-1,-1,-1,-1,-1,-1,-1,-1,-1,-1,-1,-1,-1,-1,-1,-1,-1,-1,-1,-1,-1,1
1,-1,-1,-1,-1,-1,-1,-1,-1,-1,-1,22,-1,-1,-1,-1,22,-1,-1,-1,-1,22,-1,1
1,-1,-1,-1,-1,-1,-1,-1,11,-1,-1,22,-1,-1,-1,-1,22,-1,-1,-1,-1,22,-1,1
1,-1,-1,-1,-1,-1,-1,-1,20,-1,-1,22,-1,-1,-1,-1,22,21,-1,-1,-1,22,-1,1
1,-1,-1,-1,-1,-1,-1,-1,1,-1,-1,-1,-1,-1,-1,-1,-1,1,-1,-1,-1,-1,-1,1
1,-1,-1,-1,5,-1,-1,-1,-1,-1,-1,-1,-1,-1,14,-1,-1,-1,-1,-1,-1,10,-1,1
1,-1,1,1,1,1,1,-1,-1,-1,-1,-1,1,1,1,1,-1,-1,-1,1,1,1,1,1
1,-1,-1,-1,-1,-1,-1,-1,-1,-1,-1,-1,-1,-1,-1,-1,-1,-1,1,1,1,1,6,6
1,-1,-1,-1,13,21,-1,-1,-1,-1,-1,-1,-1,-1,-1,-1,12,1,1,1,1,6,6,6
1,1,1,1,1,1,1,1,1,1,1,1,1,1,1,1,1,1,1,1,6,6,6,6
